LEVEL_START:1
NAME:Niveau Custom 1
DATA_START
#                                                          #
#                                                          #
#                             #####                        #
#                            #                             #
#                          ##                V  V          #
#                          #              V                #
#                         ##                               #
# P                  C    #        E     V               F #
############################################################
############################################################

DATA_END
LEVEL_END
